おどろく	/surprised	固有名詞
ふまんをあらわす	/angry	固有名詞
ふまん	/angry	固有名詞
おこる	/furious	固有名詞
てれる	/blush	固有名詞
おじぎ	/bow	固有名詞
おじぎする	/bow	固有名詞
おうえん	/cheer	固有名詞
おうえんする	/cheer	固有名詞
はくしゅ	/clap	固有名詞
はくしゅする	/clap	固有名詞
てまねき	/beckon	固有名詞
てまねきする	/beckon	固有名詞
なぐさめる	/comfort	固有名詞
なく	/cry	固有名詞
おどる	/dance	固有名詞
といつめる	/doubt	固有名詞
いねむり	/doze	固有名詞
いねむりする	/doze	固有名詞
くやしがる	/fume	固有名詞
さようなら	/goodbye	固有名詞
てをふる	/wave	固有名詞
あきれる	/huh	固有名詞
よろこぶ	/joy	固有名詞
ひざまずく	/kneel	固有名詞
わらう	/chuckle	固有名詞
おおわらい	/laugh	固有名詞
おおわらいする	/laugh	固有名詞
みわたす	/lookout	固有名詞
あぴーる	/me	固有名詞
あぴーるする	/me	固有名詞
くびをよこにふる	/no	固有名詞
ひていする	/deny	固有名詞
あわてる	/panic	固有名詞
ゆびさす	/point	固有名詞
つつく	/poke	固有名詞
しょうさん	/congratulate	固有名詞
しょうさんする	/congratulate	固有名詞
かつをいれる	/psych	固有名詞
けいれい	/salute	固有名詞
けいれいする	/salute	固有名詞
どうてんする	/shocked	固有名詞
かたをすくめる	/shrug	固有名詞
はげます	/rally	固有名詞
なだめる	/soothe	固有名詞
よろめく	/stagger	固有名詞
のびをする	/stretch	固有名詞
すねる	/sulk	固有名詞
かんがえる	/think	固有名詞
がっかり	/upset	固有名詞
がっかりする	/upset	固有名詞
かんげい	/welcome	固有名詞
かんげいする	/welcome	固有名詞
うなずく	/yes	固有名詞
こうていする	/thumbsup	固有名詞
じぶんをみる	/examineself	固有名詞
じぶんをみせる	/examineself	固有名詞
ぽーず	/pose	固有名詞
なげきっす	/blowkiss	固有名詞
なげきっすをする	/blowkiss	固有名詞
どげざ	/grovel	固有名詞
どげざをする	/grovel	固有名詞
すごくよろこぶ	/happy	固有名詞
すごくがっかりする	/disappointed	固有名詞
すわる	/sit	固有名詞
じめんにすわる	/sit	固有名詞
じめんにすわる	/groundsit	固有名詞
いんよう	/airquotes	固有名詞
いのる	/pray	固有名詞
ていこくしきけいれい	/imperialsalute	固有名詞
ぐらんどかんぱにーのけいれい	/gcsalute	固有名詞
なげる	/throw	固有名詞
ぽーずをかえる	/changepose	固有名詞
すてっぷだんす	/stepdance	固有名詞
ほうじょうのまい	/harvestdance	固有名詞
きゅうていのまい	/balldance	固有名詞
しんしのまい	/mandervilledance	固有名詞
なでる	/stroke	固有名詞
わたす	/handover	固有名詞
かちどき	/hurray	固有名詞
かちどきをあげる	/hurray	固有名詞
ひらてうち	/slap	固有名詞
ひらてうちをする	/slap	固有名詞
はぐ	/hug	固有名詞
はぐする	/hug	固有名詞
だきあう	/embrace	固有名詞
じけんや	/hildibrand	固有名詞
じけんやのきめぽーずをする	/hildibrand	固有名詞
さべねあんだんす	/thavdance	固有名詞
ごーるでんだんす	/golddance	固有名詞
たいようのまい	/sundance	固有名詞
たたかい	/battlestance	固有名詞
たたかいにそなえる	/battlestance	固有名詞
しょうり	/victorypose	固有名詞
しょうりをよろこぶ	/victorypose	固有名詞
もぐもぐだんす	/mogdance	固有名詞
いい	/haurchefant	固有名詞
かおをおおう	/facepalm	固有名詞
にくたいび	/flex	固有名詞
にくたいびをほこる	/flex	固有名詞
もくとう	/respect	固有名詞
もくとうをささげる	/respect	固有名詞
おねだりをする	/prettyplease	固有名詞
しんだふり	/playdead	固有名詞
しんだふりをする	/playdead	固有名詞
たいようとつきのまい	/moonlift	固有名詞
たいようとつきのまいをおどる	/moonlift	固有名詞
めがねをただす	/spectacles	固有名詞
すいめんにうく	/waterfloat	固有名詞
ちゅうがえり	/waterflip	固有名詞
すいちゅうちゅうがえり	/waterflip	固有名詞
すいちゅうちゅうがえりをする	/waterflip	固有名詞
ちからをたかめる	/powerup	固有名詞
とうほうふうのおじぎ	/easternbow	固有名詞
とうほうふうのおじぎをする	/easternbow	固有名詞
すくわっと	/squats	固有名詞
すくわっとをする	/squats	固有名詞
うでたてふせ	/pushups	固有名詞
うでたてふせをする	/pushups	固有名詞
ふっきんうんどう	/situps	固有名詞
ふっきんうんどうをする	/situps	固有名詞
しんこきゅう	/breathcontrol	固有名詞
しんこきゅうをする	/breathcontrol	固有名詞
はなし	/converse	固有名詞
はなしをする	/converse	固有名詞
きをつけ	/attention	固有名詞
きをつけのしせいをする	/attention	固有名詞
やすめ	/atease	固有名詞
やすめのしせいをする	/atease	固有名詞
かくとうくんれん	/box	固有名詞
かくとうくんれんをする	/box	固有名詞
おまじない	/ritualprayer	固有名詞
おまじないをする	/ritualprayer	固有名詞
みわくのほうよう	/charmed	固有名詞
みりょうされる	/charmed	固有名詞
みりょう	/charmed	固有名詞
みわくのほうようでみりょうされる	/charmed	固有名詞
おびえる	/tremble	固有名詞
ひざをつく	/winded	固有名詞
ぎょうてん	/aback	固有名詞
ぎょうてんする	/aback	固有名詞
あいさつ	/greet	固有名詞
あいさつする	/greet	固有名詞
よるだんす	/yoldance	固有名詞
よるだんすをおどる	/yoldance	固有名詞
みずをかける	/splash	固有名詞
あつがる	/sweat	固有名詞
さむがる	/shiver	固有名詞
せつめい	/elucidate	固有名詞
せつめいする	/elucidate	固有名詞
はなうた	/hum	固有名詞
はなうたをうたう	/hum	固有名詞
かくにんする	/confirm	固有名詞
たくらみ	/scheme	固有名詞
たくらみをはなす	/scheme	固有名詞
こころづけ	/gratuity	固有名詞
こころづけをばらまく	/gratuity	固有名詞
がっつぽーず	/fistpump	固有名詞
がっつぽーずをする	/fistpump	固有名詞
ちゅうい	/reprimand	固有名詞
ちゅういをする	/reprimand	固有名詞
じけんや	/mandervillemambo	固有名詞
じけんやのまんぼ	/mandervillemambo	固有名詞
じけんやのまんぼをおどる	/mandervillemambo	固有名詞
らりほー	/laliho	固有名詞
らりほーをする	/laliho	固有名詞
ななめだち	/lean	固有名詞
ななめだちをする	/lean	固有名詞
ずつう	/headache	固有名詞
ずつうでくるしむ	/headache	固有名詞
ぱん	/breakfast	固有名詞
ぱんをたべる	/breakfast	固有名詞
ほん	/read	固有名詞
ほんをよむ	/read	固有名詞
しゅちょうする	/insist	固有名詞
びーすてっぷ	/beesknees	固有名詞
びーすてっぷをおどる	/beesknees	固有名詞
らりぽっぷ	/lalihop	固有名詞
らりぽっぷをおどる	/lalihop	固有名詞
はいたっち	/highfive	固有名詞
はいたっちをする	/highfive	固有名詞
けいご	/guard	固有名詞
けいごをする	/guard	固有名詞
のろう	/malevolence	固有名詞
くろく	/paintblack	固有名詞
くろくぬる	/paintblack	固有名詞
あしもとをくろくぬる	/paintblack	固有名詞
あかく	/paintred	固有名詞
あかくぬる	/paintred	固有名詞
あしもとをあかくぬる	/paintred	固有名詞
きいろく	/paintyellow	固有名詞
きいろくぬる	/paintyellow	固有名詞
あしもとをきいろくぬる	/paintyellow	固有名詞
あおく	/paintblue	固有名詞
あおくぬる	/paintblue	固有名詞
あしもとをあおくぬる	/paintblue	固有名詞
おにぎり	/eatriceball	固有名詞
おにぎりをたべる	/eatriceball	固有名詞
りんご	/eatapple	固有名詞
りんごをたべる	/eatapple	固有名詞
ほうき	/sweep	固有名詞
ほうきではく	/sweep	固有名詞
もみて	/wringhands	固有名詞
もみてする	/wringhands	固有名詞
せいじゃく	/shush	固有名詞
せいじゃくをうながす	/shush	固有名詞
ぼんおどり	/bombdance	固有名詞
ぼんおどりをおどる	/bombdance	固有名詞
ぼむおどり	/bombdance	固有名詞
ぼむおどりをおどる	/bombdance	固有名詞
ひらめく	/eureka	固有名詞
せんしのえんぶいち	/rangerposered1	固有名詞
せんしのえんぶいちのうら	/rangerposered2	固有名詞
せんしのえんぶに	/rangerposeblack1	固有名詞
せんしのえんぶにのうら	/rangerposeblack2	固有名詞
せんしのえんぶさん	/rangerposeyellow1	固有名詞
せんしのえんぶさんのうら	/rangerposeyellow2	固有名詞
せんしのえんぶいちをする	/rangerposered1	固有名詞
せんしのえんぶいちのうらをする	/rangerposered2	固有名詞
せんしのえんぶにをする	/rangerposeblack1	固有名詞
せんしのえんぶにのうらをする	/rangerposeblack2	固有名詞
せんしのえんぶさんをする	/rangerposeyellow1	固有名詞
せんしのえんぶさんのうらをする	/rangerposeyellow2	固有名詞
あい	/dote	固有名詞
あいをひょうげんする	/dote	固有名詞
うたひめ	/songbird	固有名詞
うたひめをまねる	/songbird	固有名詞
せいえんあお	/cheeron	固有名詞
せいえんきいろ	/cheerwave	固有名詞
せいえんあか	/cheerjump	固有名詞
せいえんあおをおくる	/cheeron	固有名詞
せいえんきいろをおくる	/cheerwave	固有名詞
せいえんあかをおくる	/cheerjump	固有名詞
さぼてんだー	/sabotender	固有名詞
さぼてんだーぽーず	/sabotender	固有名詞
さぼてんだーぽーずをきめる	/sabotender	固有名詞
ぎもん	/consider	固有名詞
ぎもんをいだく	/consider	固有名詞
ふらだんす	/flamedance	固有名詞
ふれいむだんす	/flamedance	固有名詞
ふらだんすをおどる	/flamedance	固有名詞
ふれいむだんすをおどる	/flamedance	固有名詞
こぶし	/fistbump	固有名詞
こぶしをつきだす	/fistbump	固有名詞
ちゅうがえり	/backflip	固有名詞
ちゅうがえりをする	/backflip	固有名詞
ほうけんれい	/easterngreeting	固有名詞
ほうけんれいをする	/easterngreeting	固有名詞
うぉーむあっぷ	/warmup	固有名詞
うぉーむあっぷをする	/warmup	固有名詞
とうほう	/easterndance	固有名詞
とうほうのでんとうぶよう	/easterndance	固有名詞
とうほうのでんとうぶようをおどる	/easterndance	固有名詞
えんぶ	/crimsonlotus	固有名詞
えんぶをする	/crimsonlotus	固有名詞
ぼっくす	/boxstep	固有名詞
ぼっくすすてっぷ	/boxstep	固有名詞
ぼっくすすてっぷをふむ	/boxstep	固有名詞
さいど	/sidestep	固有名詞
さいどすてっぷ	/sidestep	固有名詞
さいどすてっぷをふむ	/sidestep	固有名詞
げっと	/getfantasy	固有名詞
げっとふぁんたじー	/getfantasy	固有名詞
げっとふぁんたじーをおどる	/getfantasy	固有名詞
ぽぽと	/popotostep	固有名詞
ぽぽとすてっぷ	/popotostep	固有名詞
ぽぽとすてっぷをふむ	/popotostep	固有名詞
ひーるとー	/heeltoe	固有名詞
ひーるとーをふむ	/heeltoe	固有名詞
ぐーぶぅー	/goobbuedo	固有名詞
ぐーぶぅーどぅ	/goobbuedo	固有名詞
ぐーぶぅーどぅをおどる	/goobbuedo	固有名詞
かんぱい	/toast	固有名詞
かんぱいする	/toast	固有名詞
ゆびぱっちん	/snap	固有名詞
すなっぷ	/snap	固有名詞
ふぃんがー	/snap	固有名詞
ふぃんがーすなっぷをする	/snap	固有名詞
すまほ	/tomestone	固有名詞
とーむすとーん	/tomestone	固有名詞
とーむすとーんをめでる	/tomestone	固有名詞
ざんてつけん	/zantetsuken	固有名詞
くうかんをきりさく	/zantetsuken	固有名詞
しゔぁ	/iceheart	固有名詞
こおりとともにまう	/iceheart	固有名詞
めがふれあ	/megaflare	固有名詞
めがふれあのごときひかりをはなつ	/megaflare	固有名詞
あるてま	/ultima	固有名詞
あるてまのごときひかりをはなつ	/ultima	固有名詞
おめがえむ	/simulationm	固有名詞
おめがえふ	/simulationf	固有名詞
おめがえむのかまえをする	/simulationm	固有名詞
おめがえふのかまえをする	/simulationf	固有名詞
わっしょい	/wasshoi	固有名詞
わっしょいする	/wasshoi	固有名詞
すのひょうじょう	/straightface	固有名詞
すのひょうじょうをする	/straightface	固有名詞
びしょう	/smile	固有名詞
びしょうをうかべる	/smile	固有名詞
えがお	/grin	固有名詞
えがおになる	/grin	固有名詞
じしん	/smirk	固有名詞
じしんにあふれるひょうじょうをする	/smirk	固有名詞
ふてき	/taunt	固有名詞
ふてきなひょうじょうをする	/taunt	固有名詞
めをとざす	/shuteyes	固有名詞
なきがお	/sad	固有名詞
なきがおになる	/sad	固有名詞
きょうふ	/scared	固有名詞
きょうふをかんじたひょうじょうをする	/scared	固有名詞
ぼうぜん	/amazed	固有名詞
ぼうぜんとしたひょうじょうをする	/amazed	固有名詞
あうち	/ouch	固有名詞
いたそうな	/ouch	固有名詞
いたそうなひょうじょうをする	/ouch	固有名詞
ふきげん	/annoyed	固有名詞
ふきげんそうなひょうじょうをする	/annoyed	固有名詞
きづいた	/alert	固有名詞
なにかにきづいた	/alert	固有名詞
なにかにきづいたようなひょうじょうをする	/alert	固有名詞
しんぱい	/worried	固有名詞
しんぱいそうなひょうじょうをする	/worried	固有名詞
ういんく	/rightwink	固有名詞
ういんく	/leftwink	固有名詞
ういんくする	/rightwink	固有名詞
ういんくする	/leftwink	固有名詞
みぎめでういんくする	/rightwink	固有名詞
ひだりめでういんくする	/leftwink	固有名詞
あくどい	/sneer	固有名詞
あくどそうなひょうじょうをする	/sneer	固有名詞
くちをすぼめる	/puckerup	固有名詞
しんけん	/concentrate	固有名詞
しんけんなひょうじょうをする	/concentrate	固有名詞
こんわく	/disturbed	固有名詞
こんわくしたひょうじょうをする	/disturbed	固有名詞
にゅうわ	/simper	固有名詞
にゅうわにほほえむ	/simper	固有名詞
みちたりた	/beam	固有名詞
みちたりたひょうじょうをする	/beam	固有名詞
はがん	/biggrin	固有名詞
はがんするひょうじょうをする	/biggrin	固有名詞
じゅくこう	/reflect	固有名詞
じゅくこうする	/reflect	固有名詞
まゆをひそめる	/furrow	固有名詞
にがわらい	/scoff	固有名詞
にがわらいをする	/scoff	固有名詞
くうそう	/ponder	固有名詞
くうそうする	/ponder	固有名詞
くうそうするようなひょうじょうをする	/ponder	固有名詞
にんたい	/endure	固有名詞
にんたいする	/endure	固有名詞
にんたいするようなひょうじょうをする	/endure	固有名詞
つくりわらい	/fakesmile	固有名詞
つくりわらいのひょうじょうをする	/fakesmile	固有名詞
ゆでたまご	/egg	固有名詞
ぶきをかまえる	/draw	固有名詞
かまえる	/draw	固有名詞
ぶきをおさめる	/sheathe	固有名詞
おさめる	/sheathe	固有名詞
いきごむ	/determined	固有名詞
こうふく	/content	固有名詞
かんせんする	/spirit	固有名詞
かんせん	/spirit	固有名詞
ぱがが	/pagaga	固有名詞
はんこつせいしんをしめす	/pagaga	固有名詞
はんこつせいしん	/pagaga	固有名詞
はんこつ	/pagaga	固有名詞
めをかがやかせる	/wow	固有名詞
かがやかせる	/wow	固有名詞