!!ATOK_TANGO_TEXT_HEADER_1
!!一覧出力
!!単語種類;登録単語(*)
!!出力日時;24/08/10 02:10

おどろく	/surprised	名詞*
ふまんをあらわす	/angry	名詞*
ふまん	/angry	名詞*
おこる	/furious	名詞*
てれる	/blush	名詞*
おじぎ	/bow	名詞*
おじぎする	/bow	名詞*
おうえん	/cheer	名詞*
おうえんする	/cheer	名詞*
はくしゅ	/clap	名詞*
はくしゅする	/clap	名詞*
てまねき	/beckon	名詞*
てまねきする	/beckon	名詞*
なぐさめる	/comfort	名詞*
なく	/cry	名詞*
おどる	/dance	名詞*
といつめる	/doubt	名詞*
いねむり	/doze	名詞*
いねむりする	/doze	名詞*
くやしがる	/fume	名詞*
さようなら	/goodbye	名詞*
てをふる	/wave	名詞*
あきれる	/huh	名詞*
よろこぶ	/joy	名詞*
ひざまずく	/kneel	名詞*
わらう	/chuckle	名詞*
おおわらい	/laugh	名詞*
おおわらいする	/laugh	名詞*
みわたす	/lookout	名詞*
あぴーる	/me	名詞*
あぴーるする	/me	名詞*
くびをよこにふる	/no	名詞*
ひていする	/deny	名詞*
あわてる	/panic	名詞*
ゆびさす	/point	名詞*
つつく	/poke	名詞*
しょうさん	/congratulate	名詞*
しょうさんする	/congratulate	名詞*
かつをいれる	/psych	名詞*
けいれい	/salute	名詞*
けいれいする	/salute	名詞*
どうてんする	/shocked	名詞*
かたをすくめる	/shrug	名詞*
はげます	/rally	名詞*
なだめる	/soothe	名詞*
よろめく	/stagger	名詞*
のびをする	/stretch	名詞*
すねる	/sulk	名詞*
かんがえる	/think	名詞*
がっかり	/upset	名詞*
がっかりする	/upset	名詞*
かんげい	/welcome	名詞*
かんげいする	/welcome	名詞*
うなずく	/yes	名詞*
こうていする	/thumbsup	名詞*
じぶんをみる	/examineself	名詞*
じぶんをみせる	/examineself	名詞*
ぽーず	/pose	名詞*
なげきっす	/blowkiss	名詞*
なげきっすをする	/blowkiss	名詞*
どげざ	/grovel	名詞*
どげざをする	/grovel	名詞*
すごくよろこぶ	/happy	名詞*
すごくがっかりする	/disappointed	名詞*
すわる	/sit	名詞*
じめんにすわる	/sit	名詞*
じめんにすわる	/groundsit	名詞*
いんよう	/airquotes	名詞*
いのる	/pray	名詞*
ていこくしきけいれい	/imperialsalute	名詞*
ぐらんどかんぱにーのけいれい	/gcsalute	名詞*
なげる	/throw	名詞*
ぽーずをかえる	/changepose	名詞*
すてっぷだんす	/stepdance	名詞*
ほうじょうのまい	/harvestdance	名詞*
きゅうていのまい	/balldance	名詞*
しんしのまい	/mandervilledance	名詞*
なでる	/stroke	名詞*
わたす	/handover	名詞*
かちどき	/hurray	名詞*
かちどきをあげる	/hurray	名詞*
ひらてうち	/slap	名詞*
ひらてうちをする	/slap	名詞*
はぐ	/hug	名詞*
はぐする	/hug	名詞*
だきあう	/embrace	名詞*
じけんや	/hildibrand	名詞*
じけんやのきめぽーずをする	/hildibrand	名詞*
さべねあんだんす	/thavdance	名詞*
ごーるでんだんす	/golddance	名詞*
たいようのまい	/sundance	名詞*
たたかい	/battlestance	名詞*
たたかいにそなえる	/battlestance	名詞*
しょうり	/victorypose	名詞*
しょうりをよろこぶ	/victorypose	名詞*
もぐもぐだんす	/mogdance	名詞*
いい	/haurchefant	名詞*
かおをおおう	/facepalm	名詞*
にくたいび	/flex	名詞*
にくたいびをほこる	/flex	名詞*
もくとう	/respect	名詞*
もくとうをささげる	/respect	名詞*
おねだりをする	/prettyplease	名詞*
しんだふり	/playdead	名詞*
しんだふりをする	/playdead	名詞*
たいようとつきのまい	/moonlift	名詞*
たいようとつきのまいをおどる	/moonlift	名詞*
めがねをただす	/spectacles	名詞*
すいめんにうく	/waterfloat	名詞*
ちゅうがえり	/waterflip	名詞*
すいちゅうちゅうがえり	/waterflip	名詞*
すいちゅうちゅうがえりをする	/waterflip	名詞*
ちからをたかめる	/powerup	名詞*
とうほうふうのおじぎ	/easternbow	名詞*
とうほうふうのおじぎをする	/easternbow	名詞*
すくわっと	/squats	名詞*
すくわっとをする	/squats	名詞*
うでたてふせ	/pushups	名詞*
うでたてふせをする	/pushups	名詞*
ふっきんうんどう	/situps	名詞*
ふっきんうんどうをする	/situps	名詞*
しんこきゅう	/breathcontrol	名詞*
しんこきゅうをする	/breathcontrol	名詞*
はなし	/converse	名詞*
はなしをする	/converse	名詞*
きをつけ	/attention	名詞*
きをつけのしせいをする	/attention	名詞*
やすめ	/atease	名詞*
やすめのしせいをする	/atease	名詞*
かくとうくんれん	/box	名詞*
かくとうくんれんをする	/box	名詞*
おまじない	/ritualprayer	名詞*
おまじないをする	/ritualprayer	名詞*
みわくのほうよう	/charmed	名詞*
みりょうされる	/charmed	名詞*
みりょう	/charmed	名詞*
みわくのほうようでみりょうされる	/charmed	名詞*
おびえる	/tremble	名詞*
ひざをつく	/winded	名詞*
ぎょうてん	/aback	名詞*
ぎょうてんする	/aback	名詞*
あいさつ	/greet	名詞*
あいさつする	/greet	名詞*
よるだんす	/yoldance	名詞*
よるだんすをおどる	/yoldance	名詞*
みずをかける	/splash	名詞*
あつがる	/sweat	名詞*
さむがる	/shiver	名詞*
せつめい	/elucidate	名詞*
せつめいする	/elucidate	名詞*
はなうた	/hum	名詞*
はなうたをうたう	/hum	名詞*
かくにんする	/confirm	名詞*
たくらみ	/scheme	名詞*
たくらみをはなす	/scheme	名詞*
こころづけ	/gratuity	名詞*
こころづけをばらまく	/gratuity	名詞*
がっつぽーず	/fistpump	名詞*
がっつぽーずをする	/fistpump	名詞*
ちゅうい	/reprimand	名詞*
ちゅういをする	/reprimand	名詞*
じけんや	/mandervillemambo	名詞*
じけんやのまんぼ	/mandervillemambo	名詞*
じけんやのまんぼをおどる	/mandervillemambo	名詞*
らりほー	/laliho	名詞*
らりほーをする	/laliho	名詞*
ななめだち	/lean	名詞*
ななめだちをする	/lean	名詞*
ずつう	/headache	名詞*
ずつうでくるしむ	/headache	名詞*
ぱん	/breakfast	名詞*
ぱんをたべる	/breakfast	名詞*
ほん	/read	名詞*
ほんをよむ	/read	名詞*
しゅちょうする	/insist	名詞*
びーすてっぷ	/beesknees	名詞*
びーすてっぷをおどる	/beesknees	名詞*
らりぽっぷ	/lalihop	名詞*
らりぽっぷをおどる	/lalihop	名詞*
はいたっち	/highfive	名詞*
はいたっちをする	/highfive	名詞*
けいご	/guard	名詞*
けいごをする	/guard	名詞*
のろう	/malevolence	名詞*
くろく	/paintblack	名詞*
くろくぬる	/paintblack	名詞*
あしもとをくろくぬる	/paintblack	名詞*
あかく	/paintred	名詞*
あかくぬる	/paintred	名詞*
あしもとをあかくぬる	/paintred	名詞*
きいろく	/paintyellow	名詞*
きいろくぬる	/paintyellow	名詞*
あしもとをきいろくぬる	/paintyellow	名詞*
あおく	/paintblue	名詞*
あおくぬる	/paintblue	名詞*
あしもとをあおくぬる	/paintblue	名詞*
おにぎり	/eatriceball	名詞*
おにぎりをたべる	/eatriceball	名詞*
りんご	/eatapple	名詞*
りんごをたべる	/eatapple	名詞*
ほうき	/sweep	名詞*
ほうきではく	/sweep	名詞*
もみて	/wringhands	名詞*
もみてする	/wringhands	名詞*
せいじゃく	/shush	名詞*
せいじゃくをうながす	/shush	名詞*
ぼんおどり	/bombdance	名詞*
ぼんおどりをおどる	/bombdance	名詞*
ぼむおどり	/bombdance	名詞*
ぼむおどりをおどる	/bombdance	名詞*
ひらめく	/eureka	名詞*
せんしのえんぶいち	/rangerposered1	名詞*
せんしのえんぶいちのうら	/rangerposered2	名詞*
せんしのえんぶに	/rangerposeblack1	名詞*
せんしのえんぶにのうら	/rangerposeblack2	名詞*
せんしのえんぶさん	/rangerposeyellow1	名詞*
せんしのえんぶさんのうら	/rangerposeyellow2	名詞*
せんしのえんぶいちをする	/rangerposered1	名詞*
せんしのえんぶいちのうらをする	/rangerposered2	名詞*
せんしのえんぶにをする	/rangerposeblack1	名詞*
せんしのえんぶにのうらをする	/rangerposeblack2	名詞*
せんしのえんぶさんをする	/rangerposeyellow1	名詞*
せんしのえんぶさんのうらをする	/rangerposeyellow2	名詞*
あい	/dote	名詞*
あいをひょうげんする	/dote	名詞*
うたひめ	/songbird	名詞*
うたひめをまねる	/songbird	名詞*
せいえんあお	/cheeron	名詞*
せいえんきいろ	/cheerwave	名詞*
せいえんあか	/cheerjump	名詞*
せいえんしろ	/cheerbright	名詞*
せいえんみどり	/cheergreen	名詞*
せいえんむらさき	/cheerviolet	名詞*
せいえんあおをおくる	/cheeron	名詞*
せいえんきいろをおくる	/cheerwave	名詞*
せいえんあかをおくる	/cheerjump	名詞*
せいえんしろをおくる	/cheerbright	名詞*
せいえんみどりをおくる	/cheergreen	名詞*
せいえんむらさきをおくる	/cheerviolet	名詞*
さぼてんだー	/sabotender	名詞*
さぼてんだーぽーず	/sabotender	名詞*
さぼてんだーぽーずをきめる	/sabotender	名詞*
ぎもん	/consider	名詞*
ぎもんをいだく	/consider	名詞*
ふらだんす	/flamedance	名詞*
ふれいむだんす	/flamedance	名詞*
ふらだんすをおどる	/flamedance	名詞*
ふれいむだんすをおどる	/flamedance	名詞*
こぶし	/fistbump	名詞*
こぶしをつきだす	/fistbump	名詞*
ちゅうがえり	/backflip	名詞*
ちゅうがえりをする	/backflip	名詞*
ほうけんれい	/easterngreeting	名詞*
ほうけんれいをする	/easterngreeting	名詞*
うぉーむあっぷ	/warmup	名詞*
うぉーむあっぷをする	/warmup	名詞*
とうほう	/easterndance	名詞*
とうほうのでんとうぶよう	/easterndance	名詞*
とうほうのでんとうぶようをおどる	/easterndance	名詞*
えんぶ	/crimsonlotus	名詞*
えんぶをする	/crimsonlotus	名詞*
ぼっくす	/boxstep	名詞*
ぼっくすすてっぷ	/boxstep	名詞*
ぼっくすすてっぷをふむ	/boxstep	名詞*
さいど	/sidestep	名詞*
さいどすてっぷ	/sidestep	名詞*
さいどすてっぷをふむ	/sidestep	名詞*
げっと	/getfantasy	名詞*
げっとふぁんたじー	/getfantasy	名詞*
げっとふぁんたじーをおどる	/getfantasy	名詞*
ぽぽと	/popotostep	名詞*
ぽぽとすてっぷ	/popotostep	名詞*
ぽぽとすてっぷをふむ	/popotostep	名詞*
ひーるとー	/heeltoe	名詞*
ひーるとーをふむ	/heeltoe	名詞*
ぐーぶぅー	/goobbuedo	名詞*
ぐーぶぅーどぅ	/goobbuedo	名詞*
ぐーぶぅーどぅをおどる	/goobbuedo	名詞*
かんぱい	/toast	名詞*
かんぱいする	/toast	名詞*
ゆびぱっちん	/snap	名詞*
すなっぷ	/snap	名詞*
ふぃんがー	/snap	名詞*
ふぃんがーすなっぷをする	/snap	名詞*
すまほ	/tomestone	名詞*
とーむすとーん	/tomestone	名詞*
とーむすとーんをめでる	/tomestone	名詞*
ざんてつけん	/zantetsuken	名詞*
くうかんをきりさく	/zantetsuken	名詞*
しヴぁ	/iceheart	名詞*
こおりとともにまう	/iceheart	名詞*
めがふれあ	/megaflare	名詞*
めがふれあのごときひかりをはなつ	/megaflare	名詞*
あるてま	/ultima	名詞*
あるてまのごときひかりをはなつ	/ultima	名詞*
おめがえむ	/simulationm	名詞*
おめがえふ	/simulationf	名詞*
おめがえむのかまえをする	/simulationm	名詞*
おめがえふのかまえをする	/simulationf	名詞*
わっしょい	/wasshoi	名詞*
わっしょいする	/wasshoi	名詞*
すのひょうじょう	/straightface	名詞*
すのひょうじょうをする	/straightface	名詞*
びしょう	/smile	名詞*
びしょうをうかべる	/smile	名詞*
えがお	/grin	名詞*
えがおになる	/grin	名詞*
じしん	/smirk	名詞*
じしんにあふれるひょうじょうをする	/smirk	名詞*
ふてき	/taunt	名詞*
ふてきなひょうじょうをする	/taunt	名詞*
めをとざす	/shuteyes	名詞*
なきがお	/sad	名詞*
なきがおになる	/sad	名詞*
きょうふ	/scared	名詞*
きょうふをかんじたひょうじょうをする	/scared	名詞*
ぼうぜん	/amazed	名詞*
ぼうぜんとしたひょうじょうをする	/amazed	名詞*
あうち	/ouch	名詞*
いたそうな	/ouch	名詞*
いたそうなひょうじょうをする	/ouch	名詞*
ふきげん	/annoyed	名詞*
ふきげんそうなひょうじょうをする	/annoyed	名詞*
きづいた	/alert	名詞*
なにかにきづいた	/alert	名詞*
なにかにきづいたようなひょうじょうをする	/alert	名詞*
しんぱい	/worried	名詞*
しんぱいそうなひょうじょうをする	/worried	名詞*
ういんく	/rightwink	名詞*
ういんく	/leftwink	名詞*
ういんくする	/rightwink	名詞*
ういんくする	/leftwink	名詞*
みぎめでういんくする	/rightwink	名詞*
ひだりめでういんくする	/leftwink	名詞*
あくどい	/sneer	名詞*
あくどそうなひょうじょうをする	/sneer	名詞*
くちをすぼめる	/puckerup	名詞*
しんけん	/concentrate	名詞*
しんけんなひょうじょうをする	/concentrate	名詞*
こんわく	/disturbed	名詞*
こんわくしたひょうじょうをする	/disturbed	名詞*
にゅうわ	/simper	名詞*
にゅうわにほほえむ	/simper	名詞*
みちたりた	/beam	名詞*
みちたりたひょうじょうをする	/beam	名詞*
はがん	/biggrin	名詞*
はがんするひょうじょうをする	/biggrin	名詞*
じゅくこう	/reflect	名詞*
じゅくこうする	/reflect	名詞*
まゆをひそめる	/furrow	名詞*
にがわらい	/scoff	名詞*
にがわらいをする	/scoff	名詞*
くうそう	/ponder	名詞*
くうそうする	/ponder	名詞*
くうそうするようなひょうじょうをする	/ponder	名詞*
にんたい	/endure	名詞*
にんたいする	/endure	名詞*
にんたいするようなひょうじょうをする	/endure	名詞*
つくりわらい	/fakesmile	名詞*
つくりわらいのひょうじょうをする	/fakesmile	名詞*
ゆでたまご	/egg	名詞*
ぶきをかまえる	/draw	名詞*
かまえる	/draw	名詞*
ぶきをおさめる	/sheathe	名詞*
おさめる	/sheathe	名詞*
いきごむ	/determined	名詞*
こうふく	/content	名詞*
かんせんする	/spirit	名詞*
かんせん	/spirit	名詞*
ぱがが	/pagaga	名詞*
はんこつせいしんをしめす	/pagaga	名詞*
はんこつせいしん	/pagaga	名詞*
はんこつ	/pagaga	名詞*
めをかがやかせる	/wow	名詞*
かがやかせる	/wow	名詞*
りんくぱーるつうしんをする	/linkpearl	名詞*
りんくぱーる	/linkpearl	名詞*
こうちゃをのむ	/tea	名詞*
こうちゃ	/tea	名詞*
ヴァレンティオンチョコを食べる	/choco	名詞*
ヴァレンティオン	/choco	名詞*
チョコを食べる	/choco	名詞*
チョコ	/choco	名詞*
おみみをぴこぴこする	/earwiggle	名詞*
おみみをぴこぴこ	/earwiggle	名詞*
おみみ	/earwiggle	名詞*
ぴこぴこする	/earwiggle	名詞*
ぴこぴこ	/earwiggle	名詞*
ひめのぶよう	/ladance	名詞*
ひめ	/ladance	名詞*
ぶよう	/ladance	名詞*
はなす	/converse	名詞*
おどろかす	/frighten	名詞*
みため	/petmirage	名詞*
むねにてをあてる	/handtoheart	名詞*
むねに	/handtoheart	名詞*
てをあてる	/handtoheart	名詞*
ぶんけんとみくらべる	/reference	名詞*
ぶんけん	/reference	名詞*
みくらべる	/reference	名詞*
たけきひかりのこうりん	/advent	名詞*
たけき	/advent	名詞*
ひかりのこうりん	/advent	名詞*
たけきひかり	/advent	名詞*
こうりん	/advent	名詞*
うなだれる	/slump	名詞*
ふらいどちきんをたべる	/eatchicken	名詞*
ちきんをたべる	/eatchicken	名詞*
ふらいどちきん	/eatchicken	名詞*
ちきん	/eatchicken	名詞*
しゅごてんせつのおまじない	/allsaintscharm	名詞*
しゅごてんせつ	/allsaintscharm	名詞*
おまじない	/allsaintscharm	名詞*
びーんず・びくとりー	/victoryreveal	名詞*
びくとりー	/victoryreveal	名詞*
びーんず	/victoryreveal	名詞*
ふぉーるがいず	/victoryreveal	名詞*
れぽりっとだんすをおどる	/lophop	名詞*
れぽりっとだんす	/lophop	名詞*
れぽりっと	/lophop	名詞*
はーとぽーず	/heart	名詞*
はーと	/heart	名詞*
おおうちわであおぐ	/uchiwasshoi	名詞*
おおうちわ	/uchiwasshoi	名詞*
あおぐ	/uchiwasshoi	名詞*
うちわ	/uchiwasshoi	名詞*
